11111111111
1P00E000011
10000000001
10100000001
10101C100R1
11111111111
