11111111111
1P100001E11
10100000001
10100000001
10001C100R1
11111111111
