111111111111111
1P0000100010E01
100C00100000001
100000100000001
1000001000000R1
111111111111111
