11111111111111
1P00E001010001
10000000000001
101000000R0001
10000000000001
10101C10001111
11111111111111
